###################################################
#                                                 #
#                                                 #
#                                                 #
#                                                 #
#                                                 #
#                                                 #
#                                                 #
#                                                 #
#                                                 #
#                                                 #
#                                                 #
#                                                 #
#                                                 #
#                                                 #
#                                                 #
#                                                 #
#                                                 #
#                                                 #
#                                                 #
#                                                 #
#                                                 #
#                                                 #
#                                                 #
#                                                 #
#                                                 #
#                           e                     #
#                                                 #
#                     ##                          #
#                                                 #
#               ##                                #
#         ##                                      #
#   ##                                            #
#                                              s  #
#                                                 #
###################################################