###################################################
#                                               e #
#                                                 #
#               ###################################
#           ####                                  #
#      ##                                         #
#                                                 #
#                                                 #
###############                                   #
#                                                 #
#                 ###                             #
#                                                 #
#                       #######                   #
#                                                 #
#                                                 #
#                                ########         #
#                                                 #
#                                                 #
#                                          ##     #
#                                                 #
#                                                 #
#                                      ##         #
#                                                 #
#                                                 #
#          ##############     ########            #
#                                                 #
#                                                 #
#      ##                                         #
#                                                 #
#                                                 #
#   ##                                            #
#                                               s #
#                                                 #
#    #####################      ###################
#                                                 #
##########################      ###################