###################################################
#                                                 #
#                                                 #
#                                           s     #
#                                                 #
#                                                 #
#                                                 #
#                                                 #
#                                                 #
#                                                 #
#                                                 #
#                                                 #
#                                                 #
#                                                 #
#                                                 #
#                                                 #
#                                                 #
#                                                 #
#                                                 #
#                                                 #
#                                                 #
#                                                 #
#                                                 #
#                                                 #
#                                                 #
#                                                 #
#                                                 #
#                                                 #
#                                                 #
#                                                 #
#                                                 #
#                         e                       #
#                                                 #
#                                                 #
#                                                 #
#                                                 #