###      ##########################################
#                                                 #
#                                                 #
#       ##########################          e     #
#                                                 #
####                              #################
#                                                 #
#                                                 #
#   #####                                         #
#                                                 #
#           ###############                       #
#                                                 #
#                              ###                #
#                                                 #
#                                     ###         #
#                                                 #
#                                                 #
#       #####################################     #
#                                                 #
####                                              #
#                                                 #
#       ###                                       #
#                                                 #
####                                              #
#                                                 #
#       ###                                       #
#                                                 #
####                                              #
#                                                 #
#                                                 #
#      ##################                         #
#                        ##                       #
#                                                 #
#                               #####      ##s    #
#                                                 #
#                                                 #