###################################################
#                                                 #
#                                                 #
#  s                                              #
#    ########     ########     ###                #
####                              ###########     #
#                                                 #
#                                                 #
#                                            ######
#                                                 #
#                       ###############           #
#                                                 #
#                                                 #
#                                                 #
#                                                 #
#                                                 #
#                                                 #
#                                                 #
#                                                 #
#     ###                                         #
#                                                 #
#       ###                                       #
#                                                 #
####                                              #
#                                                 #
#       ###                                       #
#                                                 #
####                                              #
#                                                 #
#                                                 #
#       ====                                      #
#                                                 #
#                                                 #
#        e                                        #
#                                                 #
#                                                 #