###############                                   #
#                                                 #
#                                                 #
#    ######                                    e  #
#                                                 #
###         #####      ######      #######        #
#                                                 #
#    ##                                           #
#                                                 #
#                                                 #
###                                               #
#                                                 #
#                                                 #
#    ##                                           #
#                                                 #
#                                                 #
###                                               #
#                                                 #
#                                                 #
#    ##                                           #
#                                                 #
#                                                 #
###########################################       #
#                                                 #
#                                                 #
#      ############################################
#                                                 #
#                                                 #
##########################################        #
#                                                 #
#                                           #######
#                                                 #
#                                     ====        #
#                                                 #
# s ###      ====      ====      ====             #
#                                                 #