###################################################
#                                                 #
#                                                 #
##s###########################################    #
#                                                 #
#                                                 #
#    ##############################################
#                                                 #
#                                                 #
#                                                 #
###########                                       #
#          ##################################     #
#                                           #     #
#                                           #     #
#          ##########################       #     #
#       ###                      e  #       #     #
#                                   ###     #     #
#                                   #       #     #
#                                   #       #     #
#                            ###    #    ####     #
#                                   #       #     #
#             #############         #       #     #
#                                   ###     #     #
#                                   #       #     #
#####################################       #     #
#                                         ###     #
#                                           #     #
#                                           #     #
#     #######################################     #
#                                           #     #
#                                                 #
###                                               #
#                                                 #
#                                                 #
# =====      ====      ====      =====      #######
#                                                 #