###################################################
#                                                 #
#                                                 #
#  e!!!!!!!!!!!!!!!!!!!!!!!!!!!!!!!!!!!!!!####    #
#                                                 #
#                                               ###
#                                               ###
#                    =========================#####
#                                                 #
#                ==                               #
#                                                 #
#            ==                                   #
#                                                 #
#        ==                                       #
#                                                 #
#    ##                                           #
#                                                 #
#                                                 #
###                                               #
#                                                 #
#    ##!!!!!!!!!!!!!!!!!!!!!!!!!!##==             #
#                                                 #
#                                     ==          #
#                                                 #
#                                        ==       #
#                                                 #
#                                           ==    #
#                                                 #
#                                                 #
#   ##!!!!!!!!!!!!!!!!!!!!!!!!!!!!!!!!!!!!!!!!!####
#                                                 #
###                                               #
#                                                 #
#   ##!!!!!!!!!!!!!!!!!!!!!!!!!!!!!!!!!!!!!!!!!s  #
#                                                 #
#                                                 #